#S   #                                            #
#    #                                            #
#.   #                                            #
######                                            #
                       #
                       #
                       #
                       #
                       #
########################################### #######
                       #
B                                                 #
###################################################