
    S
    .

#########
#       #
#       #
#   B   #
#       #
#       #
#########