############################
#............##............#
#.####.#####.##.#####.####.#
#@####.#####.##.#####.####@#
#.####.#####.##.#####.####.#
#..........................#
#.####.##.########.##.####.#
#.####.##.########.##.####.#
#......##....##....##......#
######.##### ## #####.######
######.##### ## #####.######
######.##    B     ##.######
######.## ###GG### ##.######
######.## #      # ##.######
|~~~~~.   #I PH C#   .~~~~~|
######.## #      # ##.######
######.## ######## ##.######
######.##    F     ##.######
######.## ######## ##.######
######.## ######## ##.######
#............##............#
#.####.#####.##.#####.####.#
#.####.#####.##.#####.####.#
#@..##....... S.......##..@#
###.##.##.########.##.##.###
###.##.##.########.##.##.###
#......##....##....##......#
#.##########.##.##########.#
#.##########.##.##########.#
#..........................#
############################